0 0 0 0 7 0 0 0 3 3 0 0 1 1 2 2 2
5 0 0 0 7 7 7 0 0 3 0 0 1 1 1 2 2
5 0 0 3 3 3 3 0 1 1 1 1 1 0 0 1 1
5 5 0 3 3 0 0 0 1 2 2 2 2 1 0 3 0
0 0 0 0 0 0 0 0 4 0 1 2 2 1 0 0 3
3 3 0 0 5 5 0 0 4 4 0 0 3 3 0 5 0
3 0 0 6 6 5 0 6 0 0 0 0 3 3 6 5 0
3 0 0 0 3 3 0 0 6 5 5 0 3 0 6 0 3
0 0 3 3 3 3 0 0 0 0 5 0 0 0 0 1 1
6 6 0 0 0 0 4 0 6 0 4 4 1 1 1 2 2
4 0 0 0 7 4 4 0 6 6 1 1 1 2 2 2 2
4 4 0 7 7 4 0 0 0 2 2 2 2 2 2 2 2

