0 1 1 2 2 2 2 2 2 2 2 2 2 2 2 1 1 0 0 0 4 4 4 0 0 7 7 7 3 3 3 3 3 0 0 0 0 0 0 0 0 0 0 3 3 0 0 3 3 3
0 1 1 8 2 2 2 2 2 2 2 2 2 2 8 1 1 1 0 0 0 4 4 0 0 0 0 7 7 3 3 3 3 0 0 0 0 0 0 4 0 0 0 0 0 0 3 0 0 3
0 0 1 1 2 2 2 2 2 2 2 2 2 2 2 2 1 1 0 0 0 0 4 4 0 0 0 0 7 0 0 3 3 3 3 0 0 0 0 4 4 4 0 0 0 3 3 0 0 0
0 1 1 2 2 2 2 2 2 2 2 2 2 2 2 8 1 1 1 0 0 0 0 0 0 3 3 3 0 0 0 0 3 3 0 0 3 0 0 4 4 0 0 3 3 0 0 0 0 3
0 1 1 8 2 2 2 2 2 2 2 2 2 2 2 2 1 1 1 0 0 0 0 0 0 0 3 3 0 0 0 0 0 0 0 0 0 3 3 0 4 4 4 4 0 3 3 3 3 0
0 1 1 2 2 2 2 2 2 2 2 2 2 2 2 2 1 1 1 1 0 0 0 4 4 0 3 3 3 3 0 6 6 6 0 0 3 3 0 4 4 4 4 0 0 0 0 0 0 0
0 1 1 2 2 2 2 2 2 2 2 2 2 2 2 2 1 1 1 0 0 0 0 4 4 0 0 0 0 0 0 0 6 6 0 0 0 0 0 0 4 4 0 0 0 3 3 3 3 0
0 1 1 8 2 2 2 2 2 2 2 2 2 2 2 2 2 2 1 1 1 0 0 0 0 0 3 3 3 0 7 7 0 6 0 0 0 0 0 0 0 0 0 0 0 0 0 3 3 0 
0 1 1 2 2 2 2 2 2 2 2 2 2 2 2 2 8 8 1 1 0 0 0 0 0 3 3 0 7 7 0 6 6 0 0 0 0 3 0 0 0 0 6 6 6 0 3 3 3 0 
0 1 1 8 2 2 2 2 2 2 2 2 2 2 2 2 1 1 1 1 0 0 0 3 3 0 0 3 0 7 7 0 6 6 0 0 0 3 0 0 0 6 6 6 0 0 0 0 0 0
0 0 1 1 8 2 2 2 2 2 2 2 2 2 2 8 1 1 1 0 0 0 0 0 0 0 0 0 0 0 7 0 0 0 0 0 0 3 0 3 0 0 0 6 0 0 3 0 0 0
0 0 0 1 1 8 8 2 2 2 2 2 2 8 8 1 1 0 0 0 0 0 0 0 0 0 0 3 3 3 0 6 6 6 0 0 3 0 3 7 0 0 0 0 3 3 0 0 0 0
4 0 0 0 0 1 1 8 8 8 2 2 8 1 1 1 7 0 0 3 3 0 3 0 3 3 0 0 0 0 0 6 6 6 6 0 0 0 7 7 7 0 0 3 3 3 0 0 0 0 
4 4 0 7 7 0 0 0 1 1 8 8 1 1 7 7 7 0 0 0 0 0 5 0 0 0 0 0 0 0 0 0 0 0 0 0 0 0 0 0 7 7 3 3 3 0 0 0 0 0 
0 0 0 7 7 7 0 0 3 0 0 0 0 0 7 7 7 7 0 0 0 5 5 5 0 0 3 0 0 4 4 4 0 0 3 3 0 0 0 7 7 0 0 0 0 3 3 0 0 4
0 0 3 3 0 3 0 0 0 0 0 0 3 3 3 0 7 0 3 0 0 0 5 5 0 3 0 0 4 4 4 4 0 0 0 0 0 5 5 0 0 0 6 6 0 0 0 0 4 4
0 0 0 3 3 3 0 0 0 0 0 0 0 0 0 0 4 0 0 0 0 0 0 0 3 3 0 0 0 0 0 0 0 0 0 0 0 5 5 5 5 0 0 6 6 6 0 0 0 4
0 0 0 0 0 0 0 4 4 4 0 3 0 0 0 0 4 4 4 0 0 0 0 5 5 0 0 0 0 3 3 0 0 0 0 0 0 5 5 5 0 0 0 0 6 6 0 0 0 0 
3 3 0 0 0 0 0 4 4 4 4 0 0 0 0 0 0 0 3 3 3 0 5 5 0 0 0 0 3 0 0 0 0 0 0 0 0 0 0 0 0 0 0 0 3 0 0 0 0 3 
0 0 0 0 0 0 4 4 4 4 4 0 0 0 0 0 0 0 0 0 0 0 0 5 5 0 0 3 0 0 0 0 0 0 0 0 0 0 0 7 3 0 0 0 0 5 0 0 5 0 
0 6 6 6 6 0 0 4 4 4 4 4 0 0 0 0 3 3 0 0 0 3 0 5 0 0 0 3 0 0 0 0 0 0 0 0 0 7 7 7 0 0 0 0 0 5 0 5 5 5 
0 3 6 6 0 0 0 0 4 4 0 0 0 0 0 0 0 0 0 4 4 3 3 0 0 0 0 0 1 1 1 1 0 0 0 0 0 0 7 7 7 0 0 4 0 0 0 0 0 5
0 0 3 3 6 6 3 0 0 3 3 0 0 0 0 0 0 0 0 0 0 4 4 0 0 0 0 1 1 1 1 1 1 1 0 0 0 0 0 0 0 0 0 4 4 0 0 0 0 0 
0 0 0 0 0 0 6 0 0 3 0 0 0 0 0 3 0 0 0 0 3 3 0 0 0 1 1 1 2 2 2 2 2 1 1 1 7 7 0 0 0 0 0 0 0 6 0 0 0 0 
0 0 0 6 6 6 0 0 0 0 0 0 0 0 0 3 0 0 0 0 0 0 0 0 1 1 1 2 2 2 2 2 2 2 1 1 1 1 7 7 7 0 0 0 0 6 6 0 0 0 
0 5 5 0 0 0 0 0 0 0 0 0 0 0 3 3 0 0 0 3 0 0 0 0 1 1 2 2 2 2 2 2 2 2 1 1 1 0 0 0 7 0 0 0 0 0 0 6 6 6 
0 0 5 5 5 5 0 0 0 3 3 3 0 0 0 0 0 0 3 0 0 0 0 0 0 1 1 1 2 2 2 2 2 2 2 2 1 1 1 0 0 0 0 0 0 0 0 3 3 0 
0 5 5 5 0 0 7 7 7 7 0 3 0 0 0 0 0 0 0 3 0 0 0 1 1 1 2 2 2 2 2 2 2 2 8 1 1 1 0 0 0 0 0 0 3 0 0 3 0 0 
0 0 5 5 0 0 0 0 7 7 0 0 0 0 3 3 0 0 0 0 3 3 0 0 1 1 8 2 2 2 2 2 2 2 1 1 1 0 0 3 0 0 0 0 3 0 0 0 0 0 
0 0 5 0 0 0 0 0 3 0 0 0 0 0 0 0 0 4 0 0 0 0 0 0 0 1 1 2 2 2 2 2 2 8 1 1 0 0 0 3 3 3 0 0 0 3 3 0 7 7 
4 4 0 0 0 3 0 0 0 3 3 3 0 0 4 4 4 4 3 0 0 0 3 0 0 1 1 8 2 2 2 8 8 1 0 0 3 0 3 0 0 0 3 3 0 0 0 0 0 7 
4 0 0 0 0 0 0 0 0 0 0 0 0 4 4 4 0 0 0 0 0 0 0 0 0 0 0 1 8 8 8 1 1 0 3 0 0 0 0 0 0 0 6 6 6 0 0 0 0 0 
0 0 3 3 3 3 3 0 3 3 3 0 6 6 6 6 0 3 0 3 0 0 7 7 0 0 0 0 0 0 0 0 0 0 0 0 0 0 0 0 0 0 6 6 6 6 6 0 0 0 
0 0 3 3 3 3 3 3 0 0 3 3 0 0 6 6 0 0 0 6 6 0 7 0 0 0 0 3 0 0 0 0 0 0 3 3 3 0 0 0 0 0 0 0 6 6 0 0 0 0 
0 0 0 3 3 3 3 3 3 0 0 3 3 0 0 0 3 0 0 0 0 6 6 0 0 0 0 0 0 0 0 0 0 0 3 3 3 3 3 3 0 0 3 3 3 0 0 0 3 3 
3 0 3 3 3 3 3 3 3 3 0 3 0 0 0 0 0 0 0 0 6 6 0 0 0 0 3 3 3 0 0 0 0 0 3 3 3 3 3 3 3 0 3 3 0 0 0 0 0 0 
3 0 0 3 3 3 3 3 3 3 3 0 0 3 0 0 0 0 0 0 0 0 0 0 0 0 0 0 0 3 0 0 0 3 3 3 3 3 3 3 0 0 3 3 3 3 3 0 0 0 
3 3 0 0 3 3 3 3 3 3 0 0 3 3 0 0 0 0 0 6 6 0 0 0 0 0 0 3 3 0 0 0 3 3 3 3 3 3 3 0 0 3 3 0 0 3 0 0 0 0 
0 0 0 3 3 3 3 3 3 3 0 0 0 0 0 3 0 0 4 4 6 0 0 0 0 0 3 3 0 0 0 0 0 3 3 3 3 3 3 3 0 0 3 3 0 0 0 0 0 0 
3 3 0 0 3 3 3 3 3 3 3 7 7 0 0 0 4 4 4 4 4 0 0 0 0 0 0 0 0 3 3 3 0 3 3 3 3 3 3 0 0 0 0 0 0 0 3 3 3 0 
0 0 0 3 0 0 0 0 0 7 7 7 0 0 4 4 4 4 4 4 4 4 0 0 0 0 0 0 0 0 0 0 0 0 0 3 3 3 0 7 7 7 0 0 0 0 0 3 0 0 
3 3 0 0 0 0 3 0 0 3 3 0 0 0 0 4 4 4 4 4 4 0 0 0 0 6 6 6 0 0 0 5 0 0 3 3 3 3 0 0 7 7 0 3 3 0 0 0 0 0 
0 3 0 0 0 0 0 0 3 3 3 0 0 0 0 0 4 4 4 4 4 0 0 0 6 0 0 0 0 0 5 5 5 5 0 0 0 0 0 0 0 0 0 0 0 0 3 0 0 0 
0 3 0 0 6 6 0 0 0 0 0 0 0 0 0 0 0 4 4 0 0 0 0 6 6 0 0 0 0 0 0 5 5 0 0 0 0 0 0 0 3 3 0 0 0 0 0 0 0 0 
0 0 0 0 0 0 6 0 0 0 0 0 0 0 0 0 0 0 0 0 0 0 0 0 0 0 0 0 0 0 0 0 0 0 0 0 0 0 0 0 0 0 0 0 0 0 0 0 0 3
0 0 0 0 0 0 0 0 0 0 3 3 3 3 0 0 0 0 0 0 0 0 0 0 0 0 0 3 3 0 0 0 0 0 0 0 3 0 0 0 0 0 3 0 0 0 0 0 0 0
0 0 0 0 0 0 0 0 0 0 0 0 0 3 0 0 0 0 0 0 0 0 0 0 0 0 0 0 0 0 0 0 0 0 0 0 0 0 0 0 3 3 0 0 0 0 0 0 0 3
0 0 0 3 0 0 0 0 0 0 0 0 3 0 0 0 0 0 0 0 0 0 3 3 3 0 0 0 0 0 0 0 0 0 0 0 0 0 0 0 0 0 0 0 0 0 0 0 0 0
0 0 0 0 0 0 0 0 0 0 0 0 0 0 0 0 0 0 0 0 0 3 4 4 4 0 0 0 0 0 0 0 0 0 0 0 3 3 0 0 0 0 0 0 0 0 0 0 0 0
0 0 0 0 3 3 3 0 0 0 0 0 3 3 0 0 0 0 0 0 0 0 4 4 4 4 0 0 0 0 0 0 0 0 0 0 0 0 0 0 0 0 0 0 0 0 0 0 0 3
