0112222222222221100044400777333330000000000330033330000666000000003330077770000066666004440300004444
0111222222222211110004400007733330000004000000300333000600000333000300077000033006666044400330000040
0011222222222222110000440000700333300004440003300000006600000330003000007703330066600040000300030000
0112222222222221111000000333000033003004400330000300000033303300000044300000333000003000033000000330
0111222222222222111000000033000000000330444403333000003000333000000444000000003300777703000000003000
0112222222222222111100044033330666003304444000000000000003300000000004440000000007770000300000000000
0011222222222222211100004400000006600000044000333300000330000111111000000030000300000003333006603000
0111222222222222221110000033307706000000000000033000330000011111111110300000550330000333300066000040
0112222222222222111100000330770660000300006660333000000001111111111111100005505503300003333040033044
0111222222222222111100033003077066000300066600000000001111122222222111111100300000777003304440003000
0011122222222221111000000000007000000303000600300000111112222222222221111110000000770003300444300600
0001111222222111100000000003330666003037000033000000111112222222222222221111100037000055000033330660
4000011111221111700330303300000666600077700333000000011111222222222222111111000444033005500030006630
4407700011111177700000500000000000000000773330000000011111122222222221111111030400333005550030330000
0007770030000077770005550030044400330007700003300444000111111122222211111110000003000660003330000440
0033030000003330703000550300444400000550006600004444400001111111111111110000000000000033000000704400
0003330000000000400000003300000000000555500666000440003000011111111110000004003300000000000077700330
0000000444030000444000055000033000000555000066000000000000000111100000300044000000030000333070000000
3300000444400000003330550000300000000000000030000330000003300000000000333004440000033000055500003000
0000004444400000000000055003000000000007300005005000333300300007777000300000000300030000005500330000
0666600444440000330003050003000000000777000005055500000000000330077700000044000000000000555033330000
0366000044000000000443300000111100000077700400000533300000066600000777000444400003300000300000000000
0033663003300000000004400001111111000000000440000000333000666660000330000440000000300000033300077000
0000006003000003000033000111222221117700000006000003330000006600000300000000000000330006600077700000
0006660000000003000000001112222222111177700006600000000003300000000300000000000000000466600000777000
0550000000000033000300001122222222111000700000066600000400000300000000333333333300004440600005000000
0055550003330000003000000111222222221110000000033000044440044000003330033333333003000444033305550000
0555007777030000000300011122222222111100000030030000044400004440033330033333330033333000000555000030
0055000077000033000033001112222222111003000030000000300440000000333300033000300330003330000550000660
0050000030000000040000000112222221110003330003307700300000000333003300300000033300003333000550066600
4400030003330044443000300111222111003030003300000770003000000000000000033000033304403333000030000063
4000000000000444000000000001111110300000006660000000003060003333000000333003330044033333300003000000
0033333033306666030300770000000000000000006666600000033066000333300033300000000333003333300000303000
0033333300330066000660700003000000333000000066000000000006600033300003330033333333300333330000000330
0003333330033000300006600000000000333333003330003300000000000003303333300033330000000000000000000000
3033333333030000000066000033300000333333303300000003000044000033300333333003300004440000777033000000
3003333333300300000000000000030003333333003333300000330040030003330005500000000444440000770000000000
3300333333003300000660000003300033333330033003000030004440033000000555555000004444440030000000000330
0003333333000003004460000033000003333333003300000030066660000000000000556000000440000003300000000003
3300333333377000444440000000033303333330000000333000006600000000007000000666000000003000000006660000
0003000007770044444444000000000000033307770000030000000660000000007770000600000003030000030006666000
3300003003300004444440000666000500333300770330000000000000000033000000000000000000004444000006000000
0300000033300000444440006000005555000000000000300003300000000000000030000000333000044400300000000000
0300660000000000044000066000000550000000330000000000000003000000000000030000000000004000000000033000
0000006000000000000000000000000000000000000000000300000000000000040000000000003300000007700000003000
0000000000333300000000000003300000003000003000000000000003000004440000000000000000000000700030003000
0000000000000300000000000000000000000000330000000330000033300044400300000000000000030000000000000000
0003000000003000000000333000000000000000000000000000000000000004440000000000000000000000000000030000
0000000000000000000003444000000000003300000000000000000044000044000000000000044430000000000000000000
0000333000003300000000444400000000000000000000000330000044443000000000000000004400033330000000033000
