2222222222222222222222222222222222222222222222222222222222222222222222222222222222222111111110000000
1122222222222222222222222222222222222222222222222222222222222222222222222222222222211111111000000000
1111111111222222222222222222222222222222222222222222222222222222222222222222222111111111110000000000
1111111111122222222222222222222222222222222222222222222222222222222222222222111111111110000000000000
1111111111112222222222222222222222222222222222222222222222222222222222222221111111111000000000000000
1111111111111222222222222222222222222222222222222222222222222222222222222111111111100000000000000000
1111111111122222222222222222222222222222222222222222222222222222222222221111111100000000000000000000
0111111111112222222222222222222222222222222222222222222222222222222222221111111000000000000000000000
0001111111111222222222222222222222222222222222222222222222222222222222111111111000000000000000000000
0000111111111112222222222222222222222222222222222222222222222222222221111111110000000000000000000000
0000011111111122222222222222222222222222222222222222222222222222222222111111111000000000000000000000
0000111111111122222222222222222222222222222222222222222222222222222221111111111110000000000000000000
0000011111111222222222222222222222222222222222222222222222222222222211111111111100000000000000000000
0000000111111122222222222222222222222222222222222222222222222222222211111111111000000000000000000000
0000000011111112222222222222222222222222222222222222222222222222222111111111100000000000000000000000
0000000001111111222222222222222222222222222222222222222222222222221111111110000000000000000000000000
0000000000111111112222222222222222222222222222222222222222222222111111111000000000000000000000000000
0000000000011111111111122222222222222222222222222222222222111111111111000000000000000000000000000000
0000000000000001111111111112222222222222222222222222221111111111111000000000000000000000000000000000
0000000000000000001111111111112222222222222222222221111111111110000000000000000000000000000000000000
0000000000000000000000001111111111222222222222222111111111111000000000000000000000000000000000000000
0000000000000000000000000011111111111111111111111111111110000000000000000000000000000000000000000000
0000000000000000000000000000111111111111111111111111111000000000000000000000000000000000000000000000
0000000000000000000000000000000111111111111111111111110000000000000000000000000000000000000000000000
0000000000000000000000000000000000000000000000000000000000000000000000000000000000000000000000000000
0000000000000000000000000000000000000000000000000000000000000000000000000000000000000000000000000000
0000000000000000000000000000000000000000000000000000000000000000000000000000000000000000000000000000
0000000000000000000000000000000000000000000000000000000000000000000000000000000000000000000000000000
0000000000000000000000000000000000000000000000000000000000000000000000000000000000000000000000000000
0000000000000000000000000000000000000000000000000000000000000000000000000000000000000000000000000000
0000000000000000000000000000000000000000000000000000000000000000000000000000000000000000000000000000
0000000000000000000000000000000000000000000000000000000000000000000000000000000000000000000000000000
0000000000000000000000000000000000000000000000000000000000000000000000000000000000111110000000000000
0000000000000000000000000000000000000000000000000000000000000000000000000000000001111111110000000000
0000000000000000000000000000000000000000000000000000000000000000000000000000000111111111111100000000
0000000000000000000000000000000000000000000000000000000000000000000000000000011111222222211110000000
0000000000000000000000000000000000000000000000000000000000000000000000000001111122222222211111000000
0000000000000000000000000000000000000000000000000000000000000000000000000001111222222222221111100000
0000000000000000000000000000000000000000000000000000000000000000000000000011111122222222222111100000
0000000000000000000000000000000000000000000000000000000000000000000000000001111112222222222211110000
0000000000000000000000000000000000000000000000000000000000000000000000000000011111222222221111100000
0000000000000000000000000000000000000000000000000000000000000000000000000000000111112222211100000000
0000000000000000000000000000000000000000000000000000000000000000000000000000000001111111111000000000
0000000000000000000000000000000000000000000000000000000000000000000000000000000000011111100000000000
0000000000000000000000000000000000000000000000000000000000000000000000000000000000000000000000000000
0000000000000000000000000000000000000000000000000000000000000000000000000000000000000000000000000000
0000011000000000000000000000000000000000000000000000000000000000000000000000000000000000000000000000
0001111111100000000000000000000000000000000000000000000000000000000000000000000000000000000000000000
0011122221111100000000000000000000000000000000000000000000000000000000000000000000000000000000000000
0011222222221111000000000000000000000000000000000000000000000000000000000000000000000000000000000000