0 1 1 2 2 2 2 2 2 2 2 2 2 2 2 1 1 0 0 0 4 4 4 0 0 7 7 7 3 3 3 3 3 0 0 0 0 0 0 0 0 0 0 3 3 0 0 3 3 3 3 0 0 0 0 6 6 6 0 0 0 0 0 0 0 0 3 3 3 0 0 7 7 7 7 0 0 0 0 0 6 6 6 6 6 0 0 4 4 4 0 3 0 0 0 0 4 4 4 4 
0 1 1 1 2 2 2 2 2 2 2 2 2 2 1 1 1 1 0 0 0 4 4 0 0 0 0 7 7 3 3 3 3 0 0 0 0 0 0 4 0 0 0 0 0 0 3 0 0 3 3 3 0 0 0 6 0 0 0 0 0 3 3 3 0 0 0 3 0 0 0 7 7 0 0 0 0 3 3 0 0 6 6 6 6 0 4 4 4 0 0 3 3 0 0 0 0 0 4 0 
0 0 1 1 2 2 2 2 2 2 2 2 2 2 2 2 1 1 0 0 0 0 4 4 0 0 0 0 7 0 0 3 3 3 3 0 0 0 0 4 4 4 0 0 0 3 3 0 0 0 0 0 0 0 6 6 0 0 0 0 0 3 3 0 0 0 3 0 0 0 0 0 7 7 0 3 3 3 0 0 6 6 6 0 0 0 4 0 0 0 0 3 0 0 0 3 0 0 0 0 
0 1 1 2 2 2 2 2 2 2 2 2 2 2 2 1 1 1 1 0 0 0 0 0 0 3 3 3 0 0 0 0 3 3 0 0 3 0 0 4 4 0 0 3 3 0 0 0 0 3 0 0 0 0 0 0 3 3 3 0 3 3 0 0 0 0 0 0 4 4 3 0 0 0 0 0 3 3 3 0 0 0 0 0 3 0 0 0 0 3 3 0 0 0 0 0 0 3 3 0 
0 1 1 1 2 2 2 2 2 2 2 2 2 2 2 2 1 1 1 0 0 0 0 0 0 0 3 3 0 0 0 0 0 0 0 0 0 3 3 0 4 4 4 4 0 3 3 3 3 0 0 0 0 0 3 0 0 0 3 3 3 0 0 0 0 0 0 4 4 4 0 0 0 0 0 0 0 0 3 3 0 0 7 7 7 7 0 3 0 0 0 0 0 0 0 0 3 0 0 0
0 1 1 2 2 2 2 2 2 2 2 2 2 2 2 2 1 1 1 1 0 0 0 4 4 0 3 3 3 3 0 6 6 6 0 0 3 3 0 4 4 4 4 0 0 0 0 0 0 0 0 0 0 0 0 0 0 3 3 0 0 0 0 0 0 0 0 0 0 4 4 4 0 0 0 0 0 0 0 0 0 7 7 7 0 0 0 0 3 0 0 0 0 0 0 0 0 0 0 0 
0 1 1 2 2 2 2 2 2 2 2 2 2 2 2 2 1 1 1 0 0 0 0 4 4 0 0 0 0 0 0 0 6 6 0 0 0 0 0 0 4 4 0 0 0 3 3 3 3 0 0 0 0 0 3 3 0 0 0 0 1 1 1 1 1 1 0 0 0 0 0 0 0 3 0 0 0 0 3 0 0 0 0 0 0 0 3 3 3 3 0 0 6 6 0 3 0 0 0 0
0 1 1 1 2 2 2 2 2 2 2 2 2 2 2 2 2 2 1 1 1 0 0 0 0 0 3 3 3 0 7 7 0 6 0 0 0 0 0 0 0 0 0 0 0 0 0 3 3 0 0 0 3 3 0 0 0 0 0 1 1 1 1 1 1 1 1 1 1 0 3 0 0 0 0 0 5 5 0 3 3 0 0 0 0 3 3 3 3 0 0 0 6 6 0 0 0 0 4 0 
0 1 1 2 2 2 2 2 2 2 2 2 2 2 2 2 1 1 1 1 0 0 0 0 0 3 3 0 7 7 0 6 6 0 0 0 0 3 0 0 0 0 6 6 6 0 3 3 3 0 0 0 0 0 0 0 0 1 1 1 1 1 1 1 1 1 1 1 1 1 1 0 0 0 0 5 5 0 5 5 0 3 3 0 0 0 0 3 3 3 3 0 4 0 0 3 3 0 4 4 
0 1 1 1 2 2 2 2 2 2 2 2 2 2 2 2 1 1 1 1 0 0 0 3 3 0 0 3 0 7 7 0 6 6 0 0 0 3 0 0 0 6 6 6 0 0 0 0 0 0 0 0 0 0 1 1 1 1 1 2 2 2 2 2 2 2 2 1 1 1 1 1 1 1 0 0 3 0 0 0 0 0 7 7 7 0 0 3 3 0 4 4 4 0 0 0 3 0 0 0 
0 0 1 1 1 2 2 2 2 2 2 2 2 2 2 1 1 1 1 0 0 0 0 0 0 0 0 0 0 0 7 0 0 0 0 0 0 3 0 3 0 0 0 6 0 0 3 0 0 0 0 0 1 1 1 1 1 2 2 2 2 2 2 2 2 2 2 2 2 1 1 1 1 1 1 0 0 0 0 0 0 0 7 7 0 0 0 3 3 0 0 4 4 4 3 0 0 6 0 0 
0 0 0 1 1 1 1 2 2 2 2 2 2 1 1 1 1 0 0 0 0 0 0 0 0 0 0 3 3 3 0 6 6 6 0 0 3 0 3 7 0 0 0 0 3 3 0 0 0 0 0 0 1 1 1 1 1 2 2 2 2 2 2 2 2 2 2 2 2 2 2 2 1 1 1 1 1 0 0 0 3 7 0 0 0 0 5 5 0 0 0 0 3 3 3 3 0 6 6 0 
4 0 0 0 0 1 1 1 1 1 2 2 1 1 1 1 7 0 0 3 3 0 3 0 3 3 0 0 0 0 0 6 6 6 6 0 0 0 7 7 7 0 0 3 3 3 0 0 0 0 0 0 0 1 1 1 1 1 2 2 2 2 2 2 2 2 2 2 2 2 1 1 1 1 1 1 0 0 0 4 4 4 0 3 3 0 0 5 5 0 0 0 3 0 0 0 6 6 3 0 
4 4 0 7 7 0 0 0 1 1 1 1 1 1 7 7 7 0 0 0 0 0 5 0 0 0 0 0 0 0 0 0 0 0 0 0 0 0 0 0 7 7 3 3 3 0 0 0 0 0 0 0 0 1 1 1 1 1 1 2 2 2 2 2 2 2 2 2 2 1 1 1 1 1 1 1 0 3 0 4 0 0 3 3 3 0 0 5 5 5 0 0 3 0 3 3 0 0 0 0 
0 0 0 7 7 7 0 0 3 0 0 0 0 0 7 7 7 7 0 0 0 5 5 5 0 0 3 0 0 4 4 4 0 0 3 3 0 0 0 7 7 0 0 0 0 3 3 0 0 4 4 4 0 0 0 1 1 1 1 1 1 1 2 2 2 2 2 2 1 1 1 1 1 1 1 0 0 0 0 0 0 3 0 0 0 6 6 0 0 0 3 3 3 0 0 0 0 4 4 0
0 0 3 3 0 3 0 0 0 0 0 0 3 3 3 0 7 0 3 0 0 0 5 5 0 3 0 0 4 4 4 4 0 0 0 0 0 5 5 0 0 0 6 6 0 0 0 0 4 4 4 4 4 0 0 0 0 1 1 1 1 1 1 1 1 1 1 1 1 1 1 1 0 0 0 0 0 0 0 0 0 0 0 0 0 0 3 3 0 0 0 0 0 0 7 0 4 4 0 0 
0 0 0 3 3 3 0 0 0 0 0 0 0 0 0 0 4 0 0 0 0 0 0 0 3 3 0 0 0 0 0 0 0 0 0 0 0 5 5 5 5 0 0 6 6 6 0 0 0 4 4 0 0 0 3 0 0 0 0 1 1 1 1 1 1 1 1 1 1 0 0 0 0 0 0 4 0 0 3 3 0 0 0 0 0 0 0 0 0 0 0 0 7 7 7 0 0 3 3 0
0 0 0 0 0 0 0 4 4 4 0 3 0 0 0 0 4 4 4 0 0 0 0 5 5 0 0 0 0 3 3 0 0 0 0 0 0 5 5 5 0 0 0 0 6 6 0 0 0 0 0 0 0 0 0 0 0 0 0 0 0 1 1 1 1 0 0 0 0 0 3 0 0 0 4 4 0 0 0 0 0 0 0 3 0 0 0 0 3 3 3 0 7 0 0 0 0 0 0 0 
3 3 0 0 0 0 0 4 4 4 4 0 0 0 0 0 0 0 3 3 3 0 5 5 0 0 0 0 3 0 0 0 0 0 0 0 0 0 0 0 0 0 0 0 3 0 0 0 0 3 3 0 0 0 0 0 0 3 3 0 0 0 0 0 0 0 0 0 0 0 3 3 3 0 0 4 4 4 0 0 0 0 0 3 3 0 0 0 0 5 5 5 0 0 0 0 3 0 0 0 
0 0 0 0 0 0 4 4 4 4 4 0 0 0 0 0 0 0 0 0 0 0 0 5 5 0 0 3 0 0 0 0 0 0 0 0 0 0 0 7 3 0 0 0 0 5 0 0 5 0 0 0 3 3 3 3 0 0 3 0 0 0 0 7 7 7 7 0 0 0 3 0 0 0 0 0 0 0 0 3 0 0 0 3 0 0 0 0 0 0 5 5 0 0 3 3 0 0 0 0 
0 6 6 6 6 0 0 4 4 4 4 4 0 0 0 0 3 3 0 0 0 3 0 5 0 0 0 3 0 0 0 0 0 0 0 0 0 7 7 7 0 0 0 0 0 5 0 5 5 5 0 0 0 0 0 0 0 0 0 0 0 3 3 0 0 7 7 7 0 0 0 0 0 0 4 4 0 0 0 0 0 0 0 0 0 0 0 0 5 5 5 0 3 3 3 3 0 0 0 0 
0 3 6 6 0 0 0 0 4 4 0 0 0 0 0 0 0 0 0 4 4 3 3 0 0 0 0 0 1 1 1 1 0 0 0 0 0 0 7 7 7 0 0 4 0 0 0 0 0 5 3 3 3 0 0 0 0 0 0 6 6 6 0 0 0 0 0 7 7 7 0 0 0 4 4 4 4 0 0 0 0 3 3 0 0 0 0 0 3 0 0 0 0 0 0 0 0 0 0 0
0 0 3 3 6 6 3 0 0 3 3 0 0 0 0 0 0 0 0 0 0 4 4 0 0 0 0 1 1 1 1 1 1 1 0 0 0 0 0 0 0 0 0 4 4 0 0 0 0 0 0 0 3 3 3 0 0 0 6 6 6 6 6 0 0 0 0 3 3 0 0 0 0 4 4 0 0 0 0 0 0 0 3 0 0 0 0 0 0 3 3 3 0 0 0 7 7 0 0 0 
0 0 0 0 0 0 6 0 0 3 0 0 0 0 0 3 0 0 0 0 3 3 0 0 0 1 1 1 2 2 2 2 2 1 1 1 7 7 0 0 0 0 0 0 0 6 0 0 0 0 0 3 3 3 0 0 0 0 0 0 6 6 0 0 0 0 0 3 0 0 0 0 0 0 0 0 0 0 0 0 0 0 3 3 0 0 0 6 6 0 0 0 7 7 7 0 0 0 0 0 
0 0 0 6 6 6 0 0 0 0 0 0 0 0 0 3 0 0 0 0 0 0 0 0 1 1 1 2 2 2 2 2 2 2 1 1 1 1 7 7 7 0 0 0 0 6 6 0 0 0 0 0 0 0 0 0 0 3 3 0 0 0 0 0 0 0 0 3 0 0 0 0 0 0 0 0 0 0 0 0 0 0 0 0 0 4 6 6 6 0 0 0 0 0 7 7 7 0 0 0 
0 5 5 0 0 0 0 0 0 0 0 0 0 0 3 3 0 0 0 3 0 0 0 0 1 1 2 2 2 2 2 2 2 2 1 1 1 0 0 0 7 0 0 0 0 0 0 6 6 6 0 0 0 0 0 4 0 0 0 0 0 3 0 0 0 0 0 0 0 0 3 3 3 3 3 3 3 3 3 3 0 0 0 0 4 4 4 0 6 0 0 0 0 5 0 0 0 0 0 0 
0 0 5 5 5 5 0 0 0 3 3 3 0 0 0 0 0 0 3 0 0 0 0 0 0 1 1 1 2 2 2 2 2 2 2 2 1 1 1 0 0 0 0 0 0 0 0 3 3 0 0 0 0 4 4 4 4 0 0 4 4 0 0 0 0 0 3 3 3 0 0 3 3 3 3 3 3 3 3 0 0 3 0 0 0 4 4 4 0 3 3 3 0 5 5 5 0 0 0 0 
0 5 5 5 0 0 7 7 7 7 0 3 0 0 0 0 0 0 0 3 0 0 0 1 1 1 2 2 2 2 2 2 2 2 1 1 1 1 0 0 0 0 0 0 3 0 0 3 0 0 0 0 0 4 4 4 0 0 0 0 4 4 4 0 0 3 3 3 3 0 0 3 3 3 3 3 3 3 0 0 3 3 3 3 3 0 0 0 0 0 0 5 5 5 0 0 0 0 3 0 
0 0 5 5 0 0 0 0 7 7 0 0 0 0 3 3 0 0 0 0 3 3 0 0 1 1 1 2 2 2 2 2 2 2 1 1 1 0 0 3 0 0 0 0 3 0 0 0 0 0 0 0 3 0 0 4 4 0 0 0 0 0 0 0 3 3 3 3 0 0 0 3 3 0 0 0 3 0 0 3 3 0 0 0 3 3 3 0 0 0 0 5 5 0 0 0 0 6 6 0 
0 0 5 0 0 0 0 0 3 0 0 0 0 0 0 0 0 4 0 0 0 0 0 0 0 1 1 2 2 2 2 2 2 1 1 1 0 0 0 3 3 3 0 0 0 3 3 0 7 7 0 0 3 0 0 0 0 0 0 0 0 3 3 3 0 0 3 3 0 0 3 0 0 0 0 0 0 3 3 3 0 0 0 0 3 3 3 3 0 0 0 5 5 0 0 6 6 6 0 0 
4 4 0 0 0 3 0 0 0 3 3 3 0 0 4 4 4 4 3 0 0 0 3 0 0 1 1 1 2 2 2 1 1 1 0 0 3 0 3 0 0 0 3 3 0 0 0 0 0 7 7 0 0 0 3 0 0 0 0 0 0 0 0 0 0 0 0 0 0 0 0 3 3 0 0 0 0 3 3 3 0 4 4 0 3 3 3 3 0 0 0 0 3 0 0 0 0 0 6 3 
4 0 0 0 0 0 0 0 0 0 0 0 0 4 4 4 0 0 0 0 0 0 0 0 0 0 0 1 1 1 1 1 1 0 3 0 0 0 0 0 0 0 6 6 6 0 0 0 0 0 0 0 0 0 3 0 6 0 0 0 3 3 3 3 0 0 0 0 0 0 3 3 3 0 0 3 3 3 0 0 4 4 0 3 3 3 3 3 3 0 0 0 0 3 0 0 0 0 0 0 
0 0 3 3 3 3 3 0 3 3 3 0 6 6 6 6 0 3 0 3 0 0 7 7 0 0 0 0 0 0 0 0 0 0 0 0 0 0 0 0 0 0 6 6 6 6 6 0 0 0 0 0 0 3 3 0 6 6 0 0 0 3 3 3 3 0 0 0 3 3 3 0 0 0 0 0 0 0 0 3 3 3 0 0 3 3 3 3 3 0 0 0 0 0 3 0 3 0 0 0 
0 0 3 3 3 3 3 3 0 0 3 3 0 0 6 6 0 0 0 6 6 0 7 0 0 0 0 3 0 0 0 0 0 0 3 3 3 0 0 0 0 0 0 0 6 6 0 0 0 0 0 0 0 0 0 0 0 6 6 0 0 0 3 3 3 0 0 0 0 3 3 3 0 0 3 3 3 3 3 3 3 3 3 0 0 3 3 3 3 3 0 0 0 0 0 0 0 3 3 0 
0 0 0 3 3 3 3 3 3 0 0 3 3 0 0 0 3 0 0 0 0 6 6 0 0 0 0 0 0 0 0 0 0 0 3 3 3 3 3 3 0 0 3 3 3 0 0 0 3 3 0 0 0 0 0 0 0 0 0 0 0 0 0 3 3 0 3 3 3 3 3 0 0 0 3 3 3 3 0 0 0 0 0 0 0 0 0 0 0 0 0 0 0 0 0 0 0 0 0 0 
3 0 3 3 3 3 3 3 3 3 0 3 0 0 0 0 0 0 0 0 6 6 0 0 0 0 3 3 3 0 0 0 0 0 3 3 3 3 3 3 3 0 3 3 0 0 0 0 0 0 0 3 0 0 0 0 4 4 0 0 0 0 3 3 3 0 0 3 3 3 3 3 3 0 0 3 3 0 0 0 0 4 4 4 0 0 0 0 7 7 7 0 3 3 0 0 0 0 0 0 
3 0 0 3 3 3 3 3 3 3 3 0 0 3 0 0 0 0 0 0 0 0 0 0 0 0 0 0 0 3 0 0 0 3 3 3 3 3 3 3 0 0 3 3 3 3 3 0 0 0 0 0 3 3 0 0 4 0 0 3 0 0 0 3 3 3 0 0 0 5 5 0 0 0 0 0 0 0 0 4 4 4 4 4 0 0 0 0 7 7 0 0 0 0 0 0 0 0 0 0 
3 3 0 0 3 3 3 3 3 3 0 0 3 3 0 0 0 0 0 6 6 0 0 0 0 0 0 3 3 0 0 0 3 3 3 3 3 3 3 0 0 3 3 0 0 3 0 0 0 0 3 0 0 0 4 4 4 0 0 3 3 0 0 0 0 0 0 5 5 5 5 5 5 0 0 0 0 0 4 4 4 4 4 4 0 0 3 0 0 0 0 0 0 0 0 0 0 3 3 0 
0 0 0 3 3 3 3 3 3 3 0 0 0 0 0 3 0 0 4 4 6 0 0 0 0 0 3 3 0 0 0 0 0 3 3 3 3 3 3 3 0 0 3 3 0 0 0 0 0 0 3 0 0 6 6 6 6 0 0 0 0 0 0 0 0 0 0 0 0 0 5 5 6 0 0 0 0 0 0 4 4 0 0 0 0 0 0 3 3 0 0 0 0 0 0 0 0 0 0 3 
3 3 0 0 3 3 3 3 3 3 3 7 7 0 0 0 4 4 4 4 4 0 0 0 0 0 0 0 0 3 3 3 0 3 3 3 3 3 3 0 0 0 0 0 0 0 3 3 3 0 0 0 0 0 6 6 0 0 0 0 0 0 0 0 0 0 7 0 0 0 0 0 0 6 6 6 0 0 0 0 0 0 0 0 3 0 0 0 0 0 0 0 0 6 6 6 0 0 0 0 
0 0 0 3 0 0 0 0 0 7 7 7 0 0 4 4 4 4 4 4 4 4 0 0 0 0 0 0 0 0 0 0 0 0 0 3 3 3 0 7 7 7 0 0 0 0 0 3 0 0 0 0 0 0 0 6 6 0 0 0 0 0 0 0 0 0 7 7 7 0 0 0 0 6 0 0 0 0 0 0 0 3 0 3 0 0 0 0 0 3 0 0 0 6 6 6 6 0 0 0 
3 3 0 0 0 0 3 0 0 3 3 0 0 0 0 4 4 4 4 4 4 0 0 0 0 6 6 6 0 0 0 5 0 0 3 3 3 3 0 0 7 7 0 3 3 0 0 0 0 0 0 0 0 0 0 0 0 0 0 0 0 0 3 3 0 0 0 0 0 0 0 0 0 0 0 0 0 0 0 0 0 0 0 0 4 4 4 4 0 0 0 0 0 6 0 0 0 0 0 0 
0 3 0 0 0 0 0 0 3 3 3 0 0 0 0 0 4 4 4 4 4 0 0 0 6 0 0 0 0 0 5 5 5 5 0 0 0 0 0 0 0 0 0 0 0 0 3 0 0 0 0 3 3 0 0 0 0 0 0 0 0 0 0 0 0 0 0 0 3 0 0 0 0 0 0 0 3 3 3 0 0 0 0 4 4 4 0 0 3 0 0 0 0 0 0 0 0 0 0 0 
0 3 0 0 6 6 0 0 0 0 0 0 0 0 0 0 0 4 4 0 0 0 0 6 6 0 0 0 0 11 11 11 11 11 0 0 0 0 0 0 3 3 0 0 0 0 0 0 0 0 0 0 0 0 0 0 0 3 0 0 0 0 0 0 0 0 0 0 0 0 0 3 0 0 0 0 0 0 0 0 0 0 0 0 4 0 0 0 0 0 0 0 0 0 0 3 3 0 0 0 
0 0 0 0 0 0 6 0 0 0 0 0 0 0 0 0 0 0 0 0 0 0 0 0 0 0 0 0 0 12 21 21 21 13 0 0 0 0 0 0 0 0 0 0 0 0 0 0 0 3 0 0 0 0 0 0 0 0 0 0 0 0 0 0 0 4 0 0 0 0 0 0 0 0 0 0 0 0 3 3 0 0 0 0 0 0 0 7 7 0 0 0 0 0 0 0 3 0 0 0 
0 0 0 0 0 0 0 0 0 0 3 3 3 3 0 0 0 0 0 0 0 0 0 0 0 0 0 0 0 12 21 21 21 13 0 0 3 0 0 20 0 0 3 0 0 0 0 0 0 20 0 0 0 0 0 0 0 3 0 0 0 0 0 4 4 4 0 0 0 0 0 0 0 0 0 0 0 0 0 0 0 0 0 0 0 0 0 0 7 0 0 0 3 0 0 0 3 0 0 0 
0 0 0 0 0 0 0 0 0 0 0 0 0 3 0 0 0 0 0 0 0 0 0 0 0 0 0 0 0 12 21 21 21 13 0 0 0 0 0 0 3 3 0 0 0 0 0 0 0 3 3 0 0 0 0 0 3 3 3 0 0 0 4 4 4 0 0 3 0 0 0 0 0 0 0 0 0 0 0 0 0 0 0 3 0 0 0 0 0 0 0 0 0 0 0 0 0 0 0 0 
0 0 0 3 0 0 0 0 0 0 0 0 3 0 0 0 0 0 0 0 0 0 3 3 3 0 0 0 0 12 21 21 21 13 0 0 0 0 0 0 0 0 0 0 0 0 0 0 9 0 0 0 0 0 0 0 0 0 0 0 0 0 0 4 4 4 0 0 0 0 0 0 0 0 0 0 0 0 0 0 0 0 0 0 0 0 0 0 0 0 0 0 0 0 0 3 0 0 0 0 
0 0 0 0 0 0 0 0 0 0 0 0 0 0 0 0 0 0 0 0 0 3 4 4 4 0 0 0 0 10 10 10 10 10 0 0 3 3 0 0 0 0 0 0 0 0 0 0 0 0 0 0 0 0 0 0 4 4 0 0 0 0 4 4 0 0 0 0 0 0 0 0 0 0 0 0 0 4 4 4 3 0 0 0 0 0 0 0 0 0 0 0 0 0 0 0 0 0 0 0 
0 0 0 0 3 3 3 0 0 0 0 0 3 3 0 0 0 0 0 0 0 0 4 4 4 4 0 0 0 0 0 0 0 0 0 0 0 0 0 0 0 0 0 0 0 0 0 0 0 0 0 0 0 0 0 0 4 4 4 4 3 0 0 0 0 0 0 0 0 0 0 0 0 0 0 0 0 0 4 4 0 0 0 3 3 3 3 0 0 0 0 0 0 0 0 3 3 0 0 0 
